10 15
###############
#             #
#             #
#   ###   ### #
#   # #   # # #
#   ###   ### #
#             #
#             #
#             #
###############
